                    
                    
                    
 #######            
   #  ###           
   # SHM######      
   # ####    #      
   # ####    #      
   #  ##     #      
   #####     #      
 ########    #      
 # ## ##     #      
 # #####     #      
##############      
#M# ##############  
###########M## # #  
 #  ###   ###  # #  
 # ############# #  
 # ####          #  
                    
